n-nitrosodiphenylamine	names
hexane	names
1,2-dichloroethane	names
carbon [inorganic plus organic]	param
p,p'-methoxychlor	param
3,4-dichloroaniline	param
chlamydomonadaceae	param
2,4-d plus 2,4-d methyl ester	param
synedra	param
golenkinia	param
n,n-diethyl-m-toluamide (deet)	param
surirella	param
stream width	param
2-chloro-2',6'-diethylacetanilide	param
sodium adsorption ratio (sar)	param
diploneis	param
bromobenzene	names
cis-1,2-dichloroethene	names
uranium-238	param
hexahydrohexamethyl cyclopentabenzopyran	param
chroomonas	param
turbidity	names
malaoxon	param
isoquinoline	param
trachelomonas	param
begin date	param
type of quality assurance data associated with sample	param
triclopyr	param
number of tentatively identified compounds (tics) from voc analysis by gcms	param
scenedesmus	param
uranium	names
sulfometuron-methyl	param
diltiazem	param
4-nonylphenol (sum of all isomers)	param
4-tert-octylphenol	param
n-pentane	param
1-naphthol	param
depth to bottom from water surface	param
2,4,6-trichlorophenol	names
disulfoton sulfone	param
sample weight	param
carbon-14 counting error	param
fenamiphos sulfoxide	param
cis-propiconazole	param
acenaphthylene	names
rhoicosphenia	param
oocystis	param
sampling method	param
mallomonas	param
1,3-dichlorobenzene	names
fenuron	param
1,2,3-trimethylbenzene	names
total coliforms	param
d-limonene	param
c6 and higher-molecular-weight hydrocarbons	param
n-butane	param
tributyl phosphate	param
dictyosphaerium	param
bromodichloromethane	names
tungsten	param
iron(ii) plus iron(iii)	param
trimethoprim	param
dichlorprop	param
tribenuron-methyl	param
sulfamethoxazole	param
chloropicrin	names
conversion factor	param
suspended sediment concentration	param
magnesium	param
topical quality-control data purpose	param
cladophora	param
pentachlorophenol	names
2,6-diethylaniline	param
dcpa monoacid	param
1,7-dimethylxanthine	param
carbon dioxide	param
dichlorodifluoromethane	names
depth to bottom at sample location	param
chrysene	names
epithemia	param
acetone	names
suspended sediment	param
1,1,1-trichloroethane	names
1,1,2,2-tetrachloroethane	names
hydrophilic acid fraction of dissolved organic carbon	param
depth to bottom of sample interval	param
bromomethane	names
nephrocytium	param
benzophenone	param
n-nitrosodiethylamine	names
gage height	param
loss on ignition of dissolved solids	param
ethylbenzene	names
strontium-87/strontium-86 ratio	param
bendiocarb	param
fipronil	param
phosmet oxygen analog	param
decafluorobiphenyl	param
biomass	param
carbamazepine	param
stephanodiscus	param
hantzschia	param
1,2,4-trimethylbenzene	names
aphanizomenon	param
agency code	param
chloramben	names
pediastrum	param
o-cresol	names
fecal coliforms	param
carbon-14	param
eptc	param
trans-crotonaldehyde	names
conductance standard nwis lot number	param
ankistrodesmus	param
trans-propiconazole	param
bicarbonate	param
tetrahydrofuran	names
1,2-dibromo-3-chloropropane	names
codeine	param
body part code	param
azinphos-methyl oxygen analog	param
9,10-anthraquinone	param
schroederia	param
pheophytin a	param
sampler type	param
lyngbya	param
organic nitrogen	param
scenedesmaceae	param
siduron	param
3,3'-dichlorobenzidine	names
metsulfuron-methyl	param
nitzschia	param
anabaenopsis	param
depth of well	param
medium code	param
coliphage	param
tritium in water molecules	param
1,3,5-trimethylbenzene	names
4-nitrophenol	names
1,1,2-trichloroethane	names
delta hydrogen-2/hydrogen-1 of methane	param
delta chromium-53/chromium-52	param
escherichia coli	param
phorate oxygen analog	param
desulfinylfipronil amide	param
specific uv absorbance at 254 nm of hydrophilic acid fraction of doc	param
chlorpyrifos oxygen analog	param
propoxur	param
gross alpha radioactivity	param
pteromonas	param
2-nitrophenol	names
cylindrospermum	param
hexachloroethane	names
cyfluthrin	param
imazethapyr	param
ammonia (nh3 + nh4+)	param
delta nitrogen-15/nitrogen-14 of nitrate	param
indole	param
type of replicate	param
styrene	names
lobomonas	param
cymbella	param
1,1-dichloroethene	names
oxidation reduction potential	param
krypton	param
phormidium	param
alpha-hch-d6	param
butane	names
iron(ii)	param
crucigenia	param
uranium (natural)	param
helium	param
acenaphthene	names
achnanthes	param
nitrate plus nitrite	param
2-methylbutane (isopentane)	param
sulfuric acid titrant nwis lot number	param
trichloromethane	names
transphilic organic acid fraction of dissolved organic carbon	param
xenon	param
dichloromethane	names
drainage area	param
2,6-dimethyl-4-heptanone	names
end date	param
sec-butylbenzene	names
2-chlorophenol	names
pebulate	param
ethene	param
clopyralid	param
coelastrum	param
4-tert-octylphenol monoethoxylate	param
oedogonium	param
lithium	param
inorganic arsenic(iii)	param
color	param
methane	param
altitude of land surface	param
cocconeis	param
ochromonas	param
benzo[ghi]perylene	names
cholesterol	param
delta sulfur-34/sulfur-32 of sulfate	param
tribufos	param
1,3-dichloropropene	names
2,4-dinitrotoluene	names
trichlorofluoromethane	names
terbuthylazine	param
indeno[1,2,3-c,d]pyrene	names
fluoranthene-d10	param
hydroxide	param
sampling depth	param
2-hydroxy-4-isopropylamino-6-ethylamino-s-triazine	param
total cell count	param
acetonitrile	names
ethoprop	param
helium-4	param
chloroethane	names
ph 7 buffer solution	param
dimethyl phthalate	names
1,4-dioxane	names
mcpa	param
ethyl acetate	names
absorbance	param
beta-sitosterol	param
anacystis	param
nitric acid nwis lot number	param
chlamydomonas	param
silica	param
tetrastrum	param
cosmarium	param
p,p'-ethyl-ddd	param
4-nonylphenol diethoxylate (sum of all isomers)	param
set number	param
odor at room temperature	param
methyl ethyl ketone	names
nicosulfuron	param
3-hydroxy carbofuran	param
noncarbonate hardness	param
station number	param
mcpb	param
benzo[b]fluoranthene	names
2,4-dimethylphenol	names
euglena	param
delta oxygen-18/oxygen-16 of nitrate	param
chlorophyll a	param
ethalfluralin	param
tert-butylbenzene	names
flow rate of well	param
carbon monoxide	param
dibromochloromethane	names
methyl methacrylate	names
cyclotella	param
location in cross section	param
n-(4-chlorophenyl)-n'-methylurea	param
diazoxon	param
fipronil sulfone	param
sodium plus potassium	param
chlorine (total residual)	names
dissolved solids dried at 105 degrees celsius	param
phacotus	param
dinitrogen	param
polychlorinated naphthalenes	param
2,4-dichlorophenol	names
chlorella	param
toluene	names
trichloroethene	names
quadrigula	param
1,1,2-trichloro-1,2,2-trifluoroethane	names
elakatothrix	param
acrylonitrile	names
1,2,3-trichloropropane	names
flumetsulam	param
ammonia	names
2-methylpropane (isobutane)	param
delta nitrogen-15/nitrogen-14 of ammonia	param
barometric pressure	param
tris(2-butoxyethyl) phosphate	param
hexachlorobutadiene	names
albuterol	param
terbufos oxygen analog sulfone	param
4-nonylphenol monoethoxylate (sum of all isomers)	param
suspended sediment discharge	param
uroglenopsis	param
acetyl hexamethyl tetrahydro naphthalene	param
mean depth of lake	param
oil and grease	names
agency analyzing sample	param
sample accounting number	param
chloramben methyl ester	param
coccochloris	param
specific uv absorbance	param
1,3-butadiene	names
depth to top of sample interval	param
phytoplankton	param
1,2,4-trichlorobenzene	names
agency collecting sample code	param
arsenite	param
fecal streptococci	param
time datum reliability code	param
site visit purpose	param
lot number	param
2,4-d	param
agmenellum	param
cloud cover	param
specific uv absorbance at 254 nm of transphilic organic acid fraction of doc	param
selenastrum	param
endosulfan	names
ethion monoxon	param
n-propylbenzene	names
inorganic carbon	param
precipitation	param
tris(2-chloroethyl) phosphate	param
fragilaria	param
tribromomethane	names
taxonomic unit code	param
organic carbon	param
glenodinium	param
tritium in water molecules counting error	param
carbon disulfide	names
pump or flow period prior to sampling	param
oxygen	param
bromochloromethane	names
hexachlorocyclopentadiene	names
hydrogen sulfide	names
2,4-db	param
filter pore size	param
tert-butyl alcohol	names
isoborneol	param
gomphonema	param
uranium-234	param
fipronil sulfide	param
fenamiphos sulfone	param
1,2-dichloropropane	names
ammonia plus organic nitrogen	param
tefluthrin	param
bis(2-chloroisopropyl) ether	names
specific uv absorbance at 254 nm of hydrophobic acid fraction of doc	param
dichlorobenzenes	names
ph	names
cis-permethrin	param
methyl acetate	names
temperature	param
2,6-dimethylnaphthalene	param
nwis lot number	param
n-nitrosodimethylamine (ndma)	names
end time	param
microspora	param
hexachlorobenzene	names
benzo[k]fluoranthene	names
radon-222	names
micractinium	param
chlorophyll b	param
coleochaete	param
propazine	names
isofenphos	param
time datum	param
benz[a]anthracene	names
flow rate	param
2-ethoxyethyl acetate	names
enterococci	param
methyl paraoxon	param
depth of hole	param
2-nitropropane	names
dichlobenil	param
tetraedron	param
melosira	param
xylene (all isomers)	names
amphora	param
3,5-dichloroaniline	param
project number	param
phacus	param
2-chloronaphthalene	names
2,6-dinitrotoluene	names
tabellaria	param
menthol	param
dissolved solids dried at 180 degrees celsius	param
bis(2-chloroethyl) ether	names
closteriopsis	param
2,4-d methyl ester	param
caffeine-13c	param
4-chloro-3-methylphenol	names
argon	param
actinastrum	param
caffeine	param
n-butylbenzene	names
4-bromophenyl phenyl ether	names
2-chloro-6-ethylamino-4-amino-s-triazine	param
3-chloropropene	names
2,4,5-trichlorophenol	names
ametryn	names
sulfide	param
kirchneriella	param
1-methylnaphthalene	param
potassium	param
bensulfuron-methyl	param
3-beta-coprostanol	param
uranium-235	param
triphenyl phosphate	param
navicula	param
hydrogen	param
sodium fraction of cations	param
dehydronifedipine	param
2-chloro-4-isopropylamino-6-amino-s-triazine	param
sampling condition	param
tetrachloroethene	names
denticula	param
cycloate	param
eudorina	param
meridion	param
ph 10 buffer solution	param
dissolved solids	param
1,2-diphenylhydrazine	names
hydrochloric acid nwis lot number	param
trans-1,2-dichloroethene	names
bromoethane	names
franceia	param
1,1-dichloroethane	names
staurastrum	param
sample source	param
diatoma	param
vinyl chloride	names
anabaena	param
bis(2-chloroethoxy)methane	names
nitrobenzene	names
diazinon-d10	param
imidacloprid	param
neburon	param
calcium	param
methiocarb	param
dimethoate	param
stigeoclonium	param
barban	param
1,2-dichlorobenzene	names
begin time	param
chodatella	param
cotinine	param
delta boron-11/boron-10	param
4-tert-octylphenol diethoxylate	param
4-cumylphenol	param
chlorogonium	param
thiabendazole	param
3-methyl-1h-indole	param
tritium	names
discharge	param
chloromethane	names
elevation of sample	param
zinc	param
tris(dichloroisopropyl) phosphate	param
carbonate	param
2,4-dinitrophenol	names
gross beta radioactivity	param
total nitrogen [nitrate + nitrite + ammonia + organic-n]	param
benzene	names
oscillatoria	param
delta carbon-13/carbon-12 of methane	param
lambda-cyhalothrin	param
1,2-dibromoethane	names
biomass to chlorophyll ratio	param
desulfinylfipronil	param
sample purpose	param
4-n-octylphenol	param
potassium-40	param
triclosan	param
2,4,5-t	param
gloeocystis	param
closterium	param
silvex	param
beta-stigmastanol	param
4-chlorotoluene	names
delta carbon-13/carbon-12 of ethane	param
cryptomonas	param
diphenhydramine	param
ph 4 buffer solution	param
bisphenol a-d14	param
mirex	param
sample volume	param
3-tert-butyl-4-hydroxyanisole	param
oxyfluorfen	param
hydrophobic acid fraction of dissolved organic carbon	param
orthophosphate	param
hardness	param
depth to water level	param
carteria	param
uronema	param
radium-224	param
propyzamide	param
myclobutanil	param
propene	param
acetaminophen	param
plectonema	param
benzoic acid	names
isopropyl acetate	names
di-n-butyl phthalate	names
2-ethyl-6-methylaniline	param
